********************
*..................*
*****.***********.**
*.***.*...........s*
*.***.***.***.****.*
*.........*...**...*
***.*****...****.***
*e..******.......***
********************