************************************************************
*..........................................................*
*****.***********.********...********************.**********
*.***.*............**......**..******************e*...******
*.***.***.***.****.**.********.....***......*****.*s*.....**
*.........*...**...**.************.***.....******...*****.**
***.*****...****.****.****..******.*****.****************..*
*...******..*....*....*.......................*....**...*.**
*...******..****.*.****.......................*..*.****.*.**
*...******..*..*.*.*..........................**.*.*..*.*.**
*...******..*..*.*.*...........................*.*.*..*.*.**
*...******..*..*.*.*.......................*****.*.*..*.*.**
*...******..*..*.*.*.......................*.....*.*..*.*.**
*...******..*..*.*.*.......................*.*****.*..*.*.**
*...******..*..*.*.*.......................*.*.....*..*.*.**
*...******..*..*.*.*************************.*.*****..*.*.**
*...******.....*.*...........................*........*...**
************************************************************