************************************************************
*......********s...........................................*
*****.***********.********...********************.**********
*.***.*............**......**..******************.*...******
*.***.***.***.****.**.********.....**************.*.*.....**
*.........*...**...**.************.**************...*****.**
***.*****...****.****.****..******.**********************..*
*...******...*...*.....***.................................*
*............********.........****.........................*
*****.***********.********...********************.**********
*.***.*............**......**********************.*...******
*.***.***.***.****.**.********.....***......*****.*.*e....**
*.........*...**...**.************.***.....******...*****.**
***.*****...****.****.****..******.*****.****************..*
*...******.......*.......................****............***
************************************************************