************************************************************
*..........................................................*
*****.***********.********...********************.**********
*.***.*............**......**..******************.*...******
*.***.***.***.****.**.********.....***......*****.*.*.....**
*.........*...**...**.************.***.....******...*****.**
***.*****e..****.****.****..******.*****.****************..*
*...******.......*........................................**
*************************************.**********************
*************************************.**********************
*..........................................................*
*****.***********.********...********************.**********
*.***.*............**......**..******************.*...******
*.***.***.***.****.**.********.....***......*****.*.*.....**
*.........*...**...**.************.***.....******...*****.**
***.*****...****.****.****..******.*****.****************..*
*...******.......*.........................................*
***********************.************************************
***********************.************************************
*..........................................................*
*****.***********.********...********************.**********
*.***.*............**......**..******************.*...******
*.***.***.***.****.**.********.....***......*****.*.*.....**
*.........*...**...**.************.***.....******...*****.**
***.*****...****.****.****..******.*****.****************..*
*...******.......*.........................................*
****************************************.*******************
****************************************.*******************
*..........................................................*
*****.***********.********...********************.**********
*.***.*............**......**..******************.*...******
*.***.***.***.****.**.********.....***......*****.*.*.....**
*.........*...**...**.************.***.....******...*****.**
***.*****...****.****.****..******.*****.****************..*
*...******.......*.........................................*
***********.********.***************************************
*..........................................................*
*****.***********.********...********************.**********
*.***.*............**......**..******************.*...******
*.***.***.***.****.**.********.....***......*****.*.*.....**
*.........*...**...**.************.***.....******...*****.**
***.*****e..****.****.****..******.*****.****************..*
*...******.......*........................................**
*************************************.**********************
*************************************.**********************
*..........................................................*
*****.***********.********...********************.**********
*.***.*............**......**..******************.*...******
*.***.***.***.****.**.********.....***......*****.*.*.....**
*.........*...**...**.************.***.....******...*****.**
***.*****...****.****.****..******.*****.****************..*
*...******.......*.........................................*
***********************.************************************
***********************.************************************
*..........................................................*
*****.***********.********...********************.**********
*.***.*............**......**..******************.*...******
*.***.***.***.****.**.********.....***......*****.*.*.....**
*.........*...**...**.************.***.....******...*****.**
***.*****...****.****.****..******.*****.****************..*
*...******.......*.........................................*
****************************************.*******************
****************************************.*******************
*..........................................................*
*****.***********.********...********************.**********
*.***.*............**......**..******************.*...******
*.***.***.***.****.**.********.....***..s...*****.*.*.....**
*.........*...**...**.************.***.....******...*****.**
***.*****...****.****.****..******.*****.****************..*
*...******.......*.........................................*
*...******.......*........................................**
*************************************.**********************
*************************************.**********************
*..........................................................*
*****.***********.********...********************.**********
*.***.*............**......**..******************.*...******
*.***.***.***.****.**.********.....***......*****.*.*.....**
*.........*...**...**.************.***.....******...*****.**
***.*****...****.****.****..******.*****.****************..*
*...******.......*.........................................*
***********************.************************************
***********************.************************************
*..........................................................*
*****.***********.********...********************.**********
*.***.*............**......**..******************.*...******
*.***.***.***.****.**.********.....***......*****.*.*.....**
*.........*...**...**.************.***.....******...*****.**
***.*****...****.****.****..******.*****.****************..*
*...******.......*.........................................*
*...******.......*........................................**
*************************************.**********************
*************************************.**********************
*..........................................................*
*****.***********.********...********************.**********
*.***.*............**......**..******************.*...******
*.***.***.***.****.**.********.....***......*****.*.*.....**
*.........*...**...**.************.***.....******...*****.**
***.*****...****.****.****..******.*****.****************..*
*...******.......*.........................................*
***********************.************************************
***********************.************************************
*..........................................................*
*****.***********.********...********************.**********
*.***.*............**......**..******************.*...******
*.***.***.***.****.**.********.....***......*****.*.*.....**
*.........*...**...**.************.***.....******...*****.**
***.*****...****.****.****..******.*****.****************..*
*...******.......*.........................................*
************************************************************