************************************************************
*..........................................................*
*****.***********.********...********************.**********
*.***.*............**......**..******************.*...******
*.***.***.***.****.**.********.....***......*****.*.*.....**
*.......***...**...**.************.***.....******...*****.**
***.*****e*.****.****.****..******.*****.****************..*
*...*******......*........................................**
**.**********.***********************.**********************
**.**********.***********************.**********************
*..........................................................*
*****.***********.********...********************.**********
*.***.*............**......**..******************.*...******
*.***.***.***.****.**.********.....***......*****.*.*.....**
*.........*...**...**.************.***.....******...*****.**
***.*****...****.****.****..******.*****.****************..*
*...******.......*.........................................*
***********************.************************************
***********************.************************************
*..........................................................*
*****.***********.********...********************.**********
*.***.*............**......**..******************.*...******
*.***.***.***.****.**.********.....***......*****.*.*.....**
*.........*...**...**.************.***.....******...*****.**
***.*****...****.****.****..******.*****.****************..*
*...******.......*.........................................*
****************************************.*******************
****************************************.*******************
*..........................................................*
*****.***********.********...********************.**********
*.***.*............**......**..******************.*...******
*.***.***.***.****.**.********.....***..s...*****.*.*.....**
*.........*...**...**.************.***.....******...*****.**
***.*****...****.****.****..******.*****.****************..*
*...******.......*.........................................*
************************************************************